, [
    // 0 1 2 3 4 5 6 7 8 9 10 11 12
    [  1,1,1,1,1,1,1,1,1,1,1, 1, 1], //0
    [  1,0,0,0,0,0,3,0,0,0,0 ,0 ,1], //1
    [  1,0,1,0,1,0,0,0,1,0,0 ,1 ,1], //2
    [  1,0,0,0,0,1,1,1,0,0,0 ,0 ,1], //3
    [  1,0,0,0,1,1,5,1,1,0,0 ,0 ,1], //4
    [  1,0,0,1,1,0,0,0,1,0,0 ,0 ,1], //5
    [  10,0,0,1,1,1,3,1,1,0,0 ,0 ,14], //6
    [  1,0,0,0,1,1,21,1,1,0,0 ,0 ,1], //7
    [  1,0,0,0,0,0,0,0,0,0,0 ,0 ,1], //8
    [  1,0,0,0,0,0,0,0,0,0,0 ,0 ,1], //9
    [  1,0,1,0,1,1,1,1,1,0,1 ,0 ,1], //10
    [  1,0,4,0,1,0,0,0,0,0,0 ,0 ,1], //11
    [  1,1,1,1,1,1,1,1,1,1 ,1 ,1,1] //12
]
, [
    // 0 1 2 3 4 5 6 7 8 9 10 11 12
    [  1,1,1,1,1,1,1,1,1,1,1, 1, 1], //0
    [  1,0,1,1,0,0,0,0,1,1,0 ,0 ,1], //1
    [  1,0,1,1,1,0,0,0,1,1,0 ,0 ,1], //2
    [  1,0,0,0,0,0,0,0,0,0,0 ,0 ,1], //3
    [  1,0,0,0,1,1,1,1,1,0,0 ,0 ,1], //4
    [  1,0,0,1,1,1,1,1,1,0,0 ,0 ,1], //5
    [  14,0,0,1,1,1,1,1,1,0,0 ,0 ,1], //6
    [  1,0,0,0,1,1,1,1,1,0,0 ,0 ,1], //7
    [  1,0,0,0,1,1,0,0,0,0,0 ,0 ,1], //8
    [  1,0,0,3,1,1,0,0,1,1,1 ,0 ,1], //9
    [  1,0,0,0,1,0,1,0,1,1,1 ,0 ,1], //10
    [  1,0,1,0,0,0,0,0,0,0,0 ,0 ,1], //11
    [  1,1,1,1,1,1,1,1,1,1,1 ,1 ,1] //12
]
]